1111111111111
10E0C0P00P001
1111111111111