11111111
111CC111
11CCCC11
111PE111
11111111