11111111111111111111111111111111111111111111111111
10ECP000000000000000000000000000000000000000000001
11111111111111111111111111111111111111111111111111
