111111111111111111111111111111
100P0C0E0000000101010101010001
111111111111111111111111111111