NO ./assets/one.xpm
SO ./assets/two.xpm
WE ./assets/three.xpm
EA ./assets/four.xpm

F 110, 10,1
C 185, 85, 85

1111111111111111111111111
1000000000100000100000011
1000000E00010000000000001
10000000000000000000000001
1000100000100000100000011
1111111111111111111111111