F 1, 2, 50
NO ./assets/one.xpm
EA ./assets/four.xpm
SO ./assets/two.xpm
WE ./assets/three.xpm
C 28, 30, 200


1111111
1W    1
10    1
1111111



