F 1, 2, 50
NO ./assets/one.xpm
EA ./assets/four.xpm
SO ./assets/two.xpm
WE ./assets/three.xpm
C 28, 30, 200


         11 11111111111 11111111
        100100000110000100000001
        1011000001110000000000001
        1001000000000000000000111
111111111110000011100000000000001
100000000011000001110111111111101
111101111111110111000000100011111
1111011111111101110101000001
1100000011010101110000000011
10000000000000001100000000001
1000000000000000110101000001
1100000100101011111011110N0111
111101110010001110100111001
    111111 11111111111 1111






a








