F 100,100,50
NO ./assets/one.xpm
SO ./assets/two.xpm
WE ./assets/three.xpm
EA ./assets/four.xpm
C 225,30,60

         11     11111111111111111111
        10011111101100001010000011
        101100000111000001 1000001
        100100000111000000100000111
  1111111111111111 111111111111111111
111111111111111111101111111111111111111111
111111111110000011100000000000001
100000000011000001110111111111101
111101111111110111000000100011111
1111011111111101110101000001
1100000011010101110000000011
10000000000000000110000010001
1000000000000000110101000001
11000001001010111110111101111
111101110010001110100111N11
    1111111111111111111111
