NO ./assets/one.xpm
SO ./assets/two.xpm
WE ./assets/three.xpm
EA ./assets/four.xpm
F 100,100,50
C 225,30,60

111111111111111111
100000000000000001
110000000000000001
100011111000000001
100000000000000001
100000000000000001
100000111111111101
10000E1        111
100000111111111101
100000000000000001
100000000000000001
100000000000000001
100000000000000001
100000000000000001
111111111111111111