1111111111111
100P0C00E0401
1111111111111