1111111111
1EC00000P1
1001C01001
1001C01CC1
1111111111