11111111
111CC111
11CCCC11
1CCCCCC1
1CCCCCC1
1CCCCCC1
1CCCCCC1
11CCCC11
111PE111
11111111