11111111111111
100000000000P1
10000000000E01
10000000000001
10000000000001
1000000C000001
10000000000001
10000000000001
10000000000001
10000000000001
10000000000001
10000000000001
10000000000001
11111111111111