111111111111111111111111111111111111111111111111111111111111
100000000000000000000000000000000000000000000000000000000001
11111111111111111111111011111111111111111111P111111111111111
100000000000000000000000E111C000000000000000C000000000000001
100000000000000000000001C111C0000000000000000C00000000000001
100000000000000000000010C111C00000000000000000C0000000000001
100000000000000000000100C111C000000000000000000C000000000001
100000000000000000100000C111C0000000CCCCCCCC0000C00000000001
100000000000000000010000C111C0000000CCCCCCCC00000C0000000001
100000000000000000000000C111C000000CCCCCCCCC000000C000000001
100000000111111111111000C111C0000000000000000000000C00000001
100000000000001100000000C111C00000CCCCCCCCCCCCCC000000000001
100000000000000100000000C111C0000000000000000000000000000001
111111111111111111111111111111111111111111111111111111111111