11111111
100E00C1
11P00011
11111111