11111111
100E00C1
11P10001
11111111