01111111110
100P0C0E111
11111111111
