111111111111111111111111111111111111111111111111111111111111
100000000000000000000000000000000000000000000000000000000001
100000000000000000000000000000000000000000000000000000000001
1P00000000C00000000C000000000000C00000000C0000C00000000C0001
11111E11111111C11111111C111111111111C1111111111111C111111111
100000000000000000000000000000000000000000000000000000000001
111111111111111111111111111111111111111111111111111111111111
